#Herzlands
SIL = "countries/SIL.txt" #Katsilbershirts
PRL = "countries/PRL.txt" #Purrlin-Lionsburg
AUR = "countries/AUR.txt" #Imperial Regency (Auralia)
LIO = "countries/LIO.txt" #Lionita
MEW = "countries/MEW.txt" #Meownich
FRA = "countries/FRA.txt" #Frankfurr
CLE = "countries/CLE.txt" #Clermeowth
PLI = "countries/PLI.txt" #Pawldrininsel
PAW = "countries/PAW.txt" #Pawris
SOB = "countries/SOB.txt" #Sobakiland
HYP = "countries/HYP.txt" #Hypurrborea
NEU = "countries/NEU.txt" #Neukats (replaces Pokin)
NAV = "countries/NAV.txt" #Navy Remnants
TAI = "countries/TAI.txt" #Tailsbaden
NKB = "countries/NKB.txt" #Neu-Kibbles
ELO = "countries/ELO.txt" #Elowia
OST = "countries/OST.txt" #Ost-Transportstaat
WPR = "countries/WPR.txt" #White Peaks Rangers
CAT = "countries/CAT.txt" #Catburg
STR = "countries/STR.txt" #Struken
MEO = "countries/MEO.txt" #Meon
PTQ = "countries/PTQ.txt" #Quarries
IMF = "countries/IMF.txt" #Imperial Frontier
KPK = "countries/KPK.txt" #Pioneer Korps
MEC = "countries/MEC.txt" #Meorseilles Cartel
HIM = "countries/HIM.txt" #Himezulte
ZUS = "countries/ZUS.txt" #Zuspri Intermarium
WAC = "countries/WAC.txt" #Wacegi Flusionian Commonwealth
NKC = "countries/NKC.txt" #Nekeox Collective
KAL = "countries/KAL.txt" #Kaiserland
KSL = "countries/KSL.txt" #Kattensteinland (NMI Katzens)

#Paluushes
PLR = "countries/PLR.txt" #Realms
HAR = "countries/HAR.txt" #Harelyne
BAT = "countries/BAT.txt" #Battlebuns
LAL = "countries/LAL.txt" #Lalaland
KAR = "countries/KAR.txt" #Karrotia

#South Pole
BSS = "countries/BSS.txt" #SÃ¼dflusionien

#Northern Solakea
KUS = "countries/KUS.txt" #Kusnurk
DOM = "countries/DOM.txt" #Dominiontracks
FSR = "countries/FSR.txt" #Freestaat Roqualien
RQA = "countries/RQA.txt" #Roquatzen Autonomy
MCF = "countries/MCF.txt" #Cloudstriders
NEK = "countries/NEK.txt" #Nekaston
SLR = "countries/SLR.txt" #Solaria
KHA = "countries/KHA.txt" #Khaganate

#Roqualia
ROQ = "countries/ROQ.txt" #Roqualia
LMB = "countries/LMB.txt" #LMB
PER = "countries/PER.txt" #Persona Inc. (Glitchopia)
ALK = "countries/ALK.txt" #Alkroa
TAK = "countries/TAK.txt" #Takicardie

#Eastern Solakea
TEN = "countries/TEN.txt" #Tenetianen
VIX = "countries/VIX.txt" #Vixenoids
FST = "countries/FST.txt" #Kaiserstein
TOI = "countries/TOI.txt" #Toiloks
PAR = "countries/PAR.txt" #Paraneon
IZW = "countries/IZW.txt" #Izwae
VAL = "countries/VAL.txt" #Valley
IMP = "countries/IMP.txt" #Imporians

#Central Solakea
SOF = "countries/SOF.txt" #Solstia
KEP = "countries/KEP.txt" #Kepler
HUF = "countries/HUF.txt" #Hushed Forest
TAL = "countries/TAL.txt" #Talsan'ar
VAS = "countries/VAS.txt" #Vasmar
COR = "countries/COR.txt" #Corebound
RSA = "countries/RSA.txt" #Roqualian Strait Authority

#Flusionea
ACR = "countries/ACR.txt" #ACR

#Arivoejo
BDR = "countries/BDR.txt" #Bundesrepublik
KTN = "countries/KTN.txt" #Katteneiland
SMP = "countries/SMP.txt" #Swamplands
MUL = "countries/MUL.txt" #Muldvarpe
LTR = "countries/LTR.txt" #Loutrien
PRC = "countries/PRC.txt" #Procione
KAP = "countries/KAP.txt" #Kapy's
BKM = "countries/BKM.txt" #Bondskrijgsmacht/Katjeisland (Not present at Gamestart)
#Oshia
SAR = "countries/SAR.txt" #Grand Duchy of Saru
DRO = "countries/DRO.txt" #Droogian Tribal Councils
FRU = "countries/FRU.txt" #Principality of Frusia
FMT = "countries/FMT.txt" #Free Macaquian Territories
VAR = "countries/VAR.txt" #Variit Harmonality
ANT = "countries/ANT.txt" #Kingdom of Antophilia
FOR = "countries/FOR.txt" #Archduchy of Formicidea
FRO = "countries/FRO.txt" #Federal Republic of Oshia
KOT = "countries/KOT.txt" #People's Republic of Kotijgrad
NFS = "countries/NFS.txt" #Novian Free State
PRO = "countries/PRO.txt" #Propania
PAC = "countries/PAC.txt" #Parelian Commonwealth
ITZ = "countries/ITZ.txt" #Itzcoatl
VRM = "countries/VRM.txt" #Volkishrepublic of Majakhemer
MAC = "countries/MAC.txt" #Maizeyrian Cornate
FKN = "countries/FKN.txt" #Freie Katzenrepublic Norddroogien
POR = "countries/POR.txt" #Commonwealth of Pordier
ENO = "countries/ENO.txt" #Enonita
NMI = "countries/NMI.txt" #Nitromethane Imperium
VPL = "countries/VPL.txt" #Vastyr Powers League
KOL = "countries/KOL.txt" #Kolechian Desert Tribes
BRA = "countries/BRA.txt" #Brambelon Greater Claims
UMR = "countries/UMR.txt" #United Military Republic
SMI = "countries/SMI.txt" #Smileycatia
FKS = "countries/FKS.txt" #Far Katzen State
CRK = "countries/CRK.txt" #Citizen Republic of New Kastra
XIR = "countries/XIR.txt" #Xealeaviu Industrial Regime
RQP = "countries/RQP.txt" #Roqkatzpolj Freeports
EUL = "countries/EUL.txt" #Democratic Volksstaat of Eulysses
USS = "countries/USS.txt" #Unitary Spri State
UST = "countries/UST.txt" #Unorganized Spri Tribes
PAN = "countries/PAN.txt" #Pangma Sultanate
SFP = "countries/SFP.txt" #Sentient Flesh Pit
BAZ = "countries/BAZ.txt" #Baza Piaskownica
LAU = "countries/LAU.txt" #United Laurnaise States
LAK = "countries/LAK.txt" #Laurendaar
ROA = "countries/ROA.txt" #Ordensstaat Roachgund
UNH = "countries/UNH.txt" #Uninhabited Territories
STW = "countries/STW.txt" #Sixteenth Wave
VIV = "countries/VIV.txt" #Vivilad Social Republic
DAW = "countries/DAW.txt" #Dawn Empire
NDF = "countries/NDF.txt" #Neuvorian Defense Federation
LUC = "countries/LUC.txt" #Latent Uplink of Cosmological Yearning
CRA = "countries/CRA.txt" #Craeythin Conformity
PGN = "countries/PGN.txt" #Prankster Gangster Nation
KOA = "countries/KOA.txt" #Kommunitat Agryll
MSN = "countries/MSN.txt" #Meridian Supernova 3
ALA = "countries/ALA.txt" #Alaari Tribal Confederacy
IOS = "countries/IOS.txt" #Imperium of Swine
SNO = "countries/SNO.txt" #Empire of Snowdonia
DUR = "countries/DUR.txt" #Duuhr Sanctuary
MER = "countries/MER.txt" #Kingdom of Mercuria
SLC = "countries/SLC.txt" #Silicron Continuum
NRW = "countries/NRW.txt" #Norvegija
RST = "countries/RST.txt" #Rustalian Union
OER = "countries/OER.txt" #Koninkryk van Oerwoud
COU = "countries/COU.txt" #The Council
RLA = "countries/RLA.txt" #Ralius League Alliance
HOM = "countries/HOM.txt" #Hunter's Order Militant
ALT = "countries/ALT.txt" #Altarian Sanctuary
ANS = "countries/ANS.txt" #Ansatarae Realms
TEM = "countries/TEM.txt" #Temland
JCS = "countries/JCS.txt" #Jeff Corporate Sovereignty
KKH = "countries/KKH.txt" #Katzenartig Kaiserliche Herrschaft
KVK = "countries/KVK.txt" #Katzenartig Vizekonigreich
BLM = "countries/BLM.txt" #Blessed Mountain
KTW = "countries/KTW.txt" #Katown Government
AKR = "countries/AKR.txt" #Artilleriekatzenrepublik
KTV = "countries/KTV.txt" #Nordkatzenvolk
PMB = "countries/PMB.txt" #Pawmalay Bunker

#Anarchy
AAA = "countries/AAA.txt" #Anarchy (for nuking

MUN = "countries/MUN.txt" #Muno
XEN = "countries/XEN.txt" #Xenon
